# Configuration File
# Format: CODE = Full Name
# Lines starting with # are comments
# You can add, remove, or modify mappings as needed

AAGH = ANTAGARH
BOCB = BELPAHAR OPEN CAST MINES III
BOCM = BELPAHAR OPEN CAST MINES
BOMB = BELPAHAR OPEN CAST MINES
BPTP = BHANUPRATAPPUR
BRMP = BIRMITRAPUR
BRMS = BIRMITRAPUR
BUA = BARADWAR
BWSB = BHOJUDIH COAL WASHERY
BYFS = Bolani
BYL = BELHA
CBSP = Cargo Berth Siding Paradeep Port
CCSP = CHASNALA COLLIERY
CHRI = CHARHI
CID = CHIRAI DONGRI
DDSP = Deep Draught Berths Paradeep Port
DLO = DALGAON
DNSD = DHORI NSD COLLY
DPCB = DHAMRA PORT
FOS = Kiriburu Fines
GBSS = GOBERWAHI BHANDARA MAHARASHTRA
GPLC = GOPALPUR  PORT
HDCB = HALDIA DOCKS
HLSR = Kalta
HSLD = Nandani
HSLH = HIRRI
IISM = Manoharpur
IOCG = IOCL AGRA
IOGS = IOCL  DIGBOI
ISCG = Gua
JAN = JARANGDIH
JCSP = JGB NO.6 COLLIERY
JDWS = JAMADOBA WASHERY
JNCP = JINAGORAL / NO 9 COLLIERY
KHBJ = KHANNA BANJARI KTR
KLOD = KELOD NAGPUR
KSDJ = KONDEY SIDING DRZ
KTWY = KATHARA WASHERY
MBWK = MODHUBAN WASHERY
MCFL = MAHANADI PVT SIDING
MCLK = KANIKA SIDING OF MCL
MCSP = PURE-JAMBAD COLLIERY SIDING
MFSJ = MAHANADI COALFIELD
MGPV = ADANI GANGAVARAM PORT
MWSD = MUNIDIH WASHERY
NLCP = NEW LAKIDIH OPEN CAST
PBSB = Barsua-Taldih
PBWB = BHELATAND WASHERY
PNWP = PATHERDIH NLW WASHERY
PSBD = BARADUAR GOODS SHED LINE NO.04
RSDG = RAJHARA
RWGR = RAJRAPPA WASHERY
SCSC = SARUBERA COLLIERY
SCW = SWANG COAL WASHERY
SOBK = Kiriburu Lumps
SONU = SONU Jodhpur
SSMK = Meghahatuburu
SWKT = BELBAID COLLIERY SIDING TAPASI
TSPD = SONAKHAN
VGSD = VIZAG GENERAL CARGO BERTH
VSPS = VISAKHAPATNAM STEEL PLANT SIDI
VSPV = VIZAG SEAPORT
VZP = VISHAKHAPATNAM-PORT
